NO ./assets/walls/brown_wall.xpm
SO ./assets/walls/dark_grey_wall.xpm
WE ./assets/walls/white_wall.xpm
EA ./assets/walls/light_gray_wall.xpm

F 255,255,255
C 0,0,0


111111111111111111111111111111111111111111111111111111111111111111111111111111111111111111111111111111111111111111111111111111111111
10E000000000000000000000000000000000000000000000000000000000000000000000000000000000000000000000000000000000000000000000000000000001
111111111111111111111111111111111111111111111111111111111111111111111111111111111111111111111111111111111111111111111111111111111111
