NO ./assets/walls/red_brick.xpm
SO ./assets/walls/turquoise_brick.xpm
WE ./assets/walls/yellow_brick.xpm
EA ./assets/walls/grey_brick.xpm

F 255,255,255
C 0,0,0

        111111111111111111111111111111111
  1111111100000000000011000100001001100001
11000000111000000000001100100001000010001                 11111
10000100001111000000000000000000100000001                10000011
10000010000111000010000000011111000001100111           11000000001
100000010001110000100000000111110000000000001111      1001001111001
1000N00010000010000100000001    100000000000000011111111001001111001
100000000100001000001000001      1000100110000000100020001001111000111
11111111110000000001000001      100010010000010010000100110000000000001
10000000000000000010000001     10001100100000010100001011110000000111101
 10000000000000001000000001   1000011000100111100111100010001111110000001
  1000001111111110000000000111000001100001100000000010001000000001000000011111
   11111000000000001100111000000110000001  1000000010000010011001000111110000111
        10001100101  10111000111110000001   100011000110001011010000010000000000111
   1111100010011100110011100011111000000011100010010011001000000101111211000001100011
11100000000000000100000202000000000000000000000001000000000010000000000001000011100001
  11111111000111111111112111111000011111111111111111100001111111111111110111100000011111111
        10000000000001000000000110000010000000000200000000000010000000001000001100001
        1011012110000010000010001000002000000001110000011000001000000000000000000111
        10001000010000000000100000011111100000110000000110000001000012111111111111
        1100100000110001111111111111111111111111111111111110000001111000000000001
       1001100000010000000000001000000000001001110000000010000111    100000100011
      100010010001000001111100010000111100000011100000000100000111  1001000101001     1111
    1100000100111100000111110002000011110001000000000001011000111111000101000101    110001
11110000000011000011000000000001000000000001000000000010000000000000000000000001111100001
10001111111011100000011111111111111111111111111111111100000001111111111111111111000000001
1000000000100000000000100000001100001000000000000001000111100000010000111000000000000001
 111001100100000000010000111100111001000001111100001000011110000110000200000000011111111
   10000000000000000100001111000000020000001  11000100001111000110000010000000111
   100000000000000001000000000011100100000111100000000002002000000000010000001
    1111100000111111111111111111111111110000010111111111111111111111111100000111
       10000001                      100000010001                       10011
       1000001                        10000000001                        11
        1000001111                     11111100001
        10000000001                          11111
        1111111111